11111111111111111
10000010000000001
10011111000001001
10000E0C000000001
111111000010C0001
10CC000C001001111
1010000C001C01P01
11111111111111111
