111111111111111111111
1P0000000X10000000001
101111111101111101101
10000000000100000X001
111101111111111111101
1C0000000000000000001
101111101X11101111001
1000001010000000000000000001
111101101011111101111
1000X10001000000C00E1
111111111111111111111
