1111111111111111111
1P00000001100000001
1011111101110111101
1000000100000100001
1111011111011101111
1C00000000100000001
1011111011101111101
1000010000000000001
1111011111111111011
100000000C0000000E1
1111111111111111111
