111111111111111111111111111
1P000C000000010000C00000001
101111111101011101111101011
10100000010101000100X001011
101011101111011101111101011
10C010001000010001000001011
111010111011111011101111011
10C010001000000001000C00011
101111101011111101111111011
100000001000000X01000000011
101111111101111101011111011
1000000X0001000001000000011
101111101111011111101111011
10C000101000C100000C0100011
111011101011111111101011011
10C010000000C0000000000E001
111111111111111111111111111
